___88___88___
__8338_8338__
_83333833338_
822222222B228
8222222222B28
8222222222B28
811111111B118
8111111111118
8777777777778
_87777777778_
__855555558__
___8555558___
____84448____
_____848_____
______8______
_____________
_____________
_____________      
