_______777___
_____7777____
___77777_____
__7777_______
_777__77_77__
7B77777B7B777
77B7B7B77777_
7B7B7B7733777
777777777333_
_777777777777
_77__77______
_777_777_____
_____________
_____________
_____________
_____________
_____________
_____________         
