__888888888__
_822222222A8_
82118888812A8
8218BBBBB82A8
828BBBBBBB8A8
828BB888BB8A8
82188888BB8A8
82118BBBB82A8
82118BBB882A8
82111888112A8
82118BBB812A8
82118BBB812A8
82211888122A8
82222222222A8
_8AAAAAAAAA8_
__888888888__
_____________
_____________      
