_____________
_____________
______00_____
_____0000____
____000000___
___00300300__
___00000000__
___00000000__
_____0__0____
_____0__0____
____0_00_0___
____0_00_0___
___0_0__0_0__
___0_0__0_0__
_____________
_____________
_____________
_____________
