______8______
_____818_____
_____818_____
____81118____
____81118____
___8111118___
___8888888___
___8111118___
__818111818__
__818111818__
_81118181118_
_81118181118_
8111118111118
8888888888888
_____________
_____________
_____________
_____________ 
