_____________
_____________
___1_____1___
___1_____1___
____1___1____
____1___1____
___0000000___
___0000000___
__003000300__
__003000300__
_00000000000_
_00000000000_
_00000000000_
_0_0000000_0_
_0_0_____0_0_
_0_0_____0_0_
____00_00____
____00_00____