______8______
_____838_____
_____838_____
____83228____
____82218____
8888221178888
8332281876658
_82218786658_
__811878658__
___8776658___
___8766558___
__876655998__
__866559948__
_86658884448_
_8658___8448_
_888_____888_
_____________
_____________
